{
  "id": "base_game:test_map",
  "name": "base_game.map.test_map.level.name",
  "description": "base_game.map.test_map.level.description",
  "maps": {
    "base_game:test_map/map_000": {
      "id": "base_game:test_map/map_000",
      "name": "base_game.map.test_map.maps.map_000.name",
      "keys": [
        "base_game:flesh_tile",
        "base_game:steel_plating_tile"
      ],
      "width": 10,
      "length": 10,
      "height": 3,
      "tiles": [
        -1, -1, -1,  0, -1, -1, -1, -1, -1, -1,
        -1, -1,  0, -1, -1, -1, -1, -1, -1, -1,
        -1,  0, -1, -1, -1, -1, -1, -1, -1, -1,
         0, -1, -1, -1, -1, -1, -1, -1, -1, -1,
        -1, -1, -1, -1, -1, -1, -1, -1, -1, -1,
        -1, -1, -1, -1, -1, -1, -1, -1, -1, -1,
        -1, -1, -1, -1, -1, -1, -1, -1, -1, -1,
        -1, -1, -1, -1, -1, -1, -1, -1, -1, -1,
        -1, -1, -1, -1, -1, -1, -1, -1, -1, -1,
        -1, -1, -1, -1, -1, -1, -1, -1, -1, -1,
        
         0,  0,  0,  0,  0,  0,  0,  0,  0,  0,
         0,  0,  0,  0,  0,  0,  0,  0,  0,  0,
         0,  0,  0,  0, -1, -1,  0,  0,  0,  0,
         0,  0,  0,  0, -1, -1, -1,  0,  0,  0,
         0,  0,  0,  0,  0, -1, -1,  0,  0,  0,
         0,  0,  0,  0,  0, -1, -1,  0,  0,  0,
        -1, -1, -1,  0,  0,  0,  0,  0,  0,  0,
        -1, -1, -1,  0,  0,  0,  0,  0,  0,  0,
        -1, -1, -1,  0,  0,  0,  0,  0,  0,  0,
        -1, -1, -1,  0,  0,  0,  0,  0,  0,  0,
        
         1,  1,  1,  1,  1,  1,  1,  1,  1,  1,
         1,  1,  1,  1,  1,  1,  1,  1,  1,  1,
         1,  1,  1,  0,  1,  1,  1,  1,  1,  1,
         1,  1,  0,  1,  1,  1,  1,  1,  1,  1,
         0,  0,  1,  1,  1,  1,  1,  1,  1,  1,
         0,  0,  1,  1,  1,  1,  1,  1,  1,  1,
         1,  0,  1,  1,  1,  1,  1,  1,  1,  1,
         1,  0,  0,  1,  1,  1,  1,  1,  1,  1,
         1,  0,  0,  1,  1,  1,  1,  1,  1,  1,
         1,  1,  1,  1,  1,  1,  1,  1,  1,  1
      ],
      "trigger_zones": {
        "spawn_1": {
            "id": "spawn_1",
            "tags": [
              "spawn_zone"
            ],
            "area": [0, 0, 0, 1, 1, 1],
            "conditions": [],
            "effects": []
        }
      }
    }
  }
}